#########
#########
###T0000#
###0###0#
#0#0L0#0#
#000P000#
#########
#########
#########
