#########
#########
###T#####
###0#####
###0L0###
###0P0###
#########
#########
#########